......3.....
.0....3.....
...XXXXX....
XXX#........
###33333....
...XXXXX##..
.3..........
........3333
XX....#####.
XX....#.....
..#####..G..
............