...............
...............
.0.##########..
XXX#.G..XXXX#..
...#3333XXXX#..
...#XXXXXXXX#..
...#.######X#..
...#3333....#..
...########.#..
...............